111111111111111111111111111111111111111111111111111111111111
10000000000000000000000000000000000000000000000000000000P001
111111111111111110000000000000000000111111111111100000001001
100C00000000000000010101010101010101010101010101010101010101
111111111111111111111111111111111111111111111111111C01111111
100000000000000000000000000000000000000000000000001101111111
100000000000000000001000000000000000000000001000E00001111111
111111111111111111111111111111111111111111111111111111111111
