11111111
1P0100C1
10C10001
10100101
10C010E1
11111111
