11111111
1P0000C1
11110101
10000111
1C1000E1
11111111
