11111111
1PC101C1
10010001
10000101
1101C1E1
11111111


11111111
11111111
