111111111111111111111
100000000000P00011001
100000111111111111101
100000000000000000011
11111111111E000000011
111111111111111111111
