11111111111111111111111111111111
10000000000000000P11111111000111
10000000C00000001111111000000011
10000010011111111111111100011101
1111111E111111111111111101001011
11111111111110111111111111111111
