111111111111111
100000001100001
111B11000111101
100011110111111
1C1000000000001
110000111111111
1111E1111111111
111111111111111
