11111111111111111111111111111
100000000000000000000000000011
10000000000000000000000000001
111111111111111111111111111111
